AROUND	ER AW N D
AROUND(2)	ER AW N
BAD	B AE D
CHRISTMAS	K R IH S M AH S
DAYS	D EY Z
GOOD	G UH D
GOOD(2)	G IH D
HOW	HH AW
LIGHT	L AY T
MANY	M EH N IY
NAUGHTY	N AO T IY
NICE	N AY S
NICE(2)	N IY S
OH	OW
OR	AO R
OR(2)	ER
PRESENTS	P R EH Z AH N T S
PRESENTS(2)	P R IY Z EH N T S
ROCK	R AA K
TREE	T R IY
UNTIL	AH N T IH L
UP	AH P
